!! 1. Goal Read lines - output original inputs + add Title from HTTP add Image link strong + download amazon image too.
!! 2.   <title> -||- <//hreflink> 
!! 3.   separator = `-||-`
!!
!!
!! ~ Web Read: Letter from a Birmingham Jail -||-  //www.africa.upenn.edu/Articles_Gen/Letter_Birmingham.html
!!
!!
!!
!!
The Measure of a Man, A Spiritual Autobiography: Sidney Portier -||-  //amzn.to/2EZCz3m
The Effective Executive - The Definitive Guide to Getting The Right Things Done: Drucker -||-  //amzn.to/2vmKmWq
Screwtape Letters : CS Lewis -||-  //amzn.to/2fvrf73
HBR: On Strategy -||-  //amzn.to/2hOxkvU
The Singularity is Near -||-  //amzn.to/2vJ0v7j
Cost of Discipleship: Bonhoeffer -||-  //amzn.to/2vmDzMk
Brave New World: Huxley -||-  //amzn.to/2vmyALE
The Rise of Theodore Roosevelt: Edmund Morris -||-  //amzn.to/2vqf9jp
The Advantage: Why Organizational Health Trumps Everything Else in Business -||-  //amzn.to/2vpYpZv
A Technique for Producing Ideas -||-  //amzn.to/2oEbkUV
Go Set a Watchman -||-  //amzn.to/2vmFqAJ
Evicted: Poverty and Profit in the American City -||-  //amzn.to/2fw4obz
Make it Stick, The Science of Successful Learning -||-  //amzn.to/2fuGsFw
Quiet: The Power of Introverts in a World That Can’t Stop Talking -||-  //amzn.to/2vITLsq
Reclaiming Conversation: The Power of Talk in a Digital Age -||-  //amzn.to/2fvRYQW
Sapiens: A Brief History of Humankind -||-  //amzn.to/2vmzCr9
The 5 Elements of Effective Thinking -||-  //amzn.to/2usmzp6
The Immortal Life of Henrietta Lacks -||-  //amzn.to/2vIxURZ
The Omnivore's Dilemma: A Natural History of Four Meals -||-  //amzn.to/2wLYAhn
The Sun Also Rises -||-  //amzn.to/2vmU6Qy
Marx's Communist Manifesto -||-  //amzn.to/2vIHTGR
Blindness -||-  //amzn.to/2fvQm9L
Serial Innovators: Firms That Change the World -||-  //amzn.to/2wxEfxd
Moby Dick: Melville -||-  //amzn.to/2i5Ondk
Originals: How Non-Conformists Move the World -||-  //amzn.to/2uIXWVo
Fighting Talk: Forty Maxims on War, Peace, and Strategy -||-  //amzn.to/2wPZPwM
Churchill: On The Power of Words -||-  //amzn.to/2w2liFc
Great People Decisions: Why They Matter So Much, Why They are So Hard, and How You Can Master Them -||- //amzn.to/2vIrVKd
What Got You Here Won't Get You There: How Successful People Become Even More Successful! -||-  //amzn.to/2vITCCV
Hillbilly Elegy: A Memoir of a Family and Culture in Crisis -||-  //amzn.to/2fKs63M
Only Humans Need Apply: Winners and Losers in the Age of Smart Machines -||-  //amzn.to/2vJcnpI
Boom Towns: Restoring the Urban American Dream -||-  //amzn.to/2vJ4P68
Life on the Edge: The Coming of Age of Quantum Biology -||-  //amzn.to/2i6pOgp
The Quantum Spy: A Thriller -||-  //amzn.to/2uIwBTi
Sam Walton: Made In America -||-  //amzn.to/2uITOVd
The End of Power : From Boardrooms to Battlefields and Churches to States, Why Being In Charge 't What It Used to Be -||-  //amzn.to/2fLsCP1
Tribal Leadership: Leveraging Natural Groups to Build a Thriving Organization -||-  //amzn.to/2x4f6cD
Emerald Mile: The Epic Story of the Fastest Ride in History Through the Heart of the Grand Canyon -||-  //amzn.to/2wQdaVN
Out Stealing Horses -||-  //amzn.to/2fL9Lnt
Shoe Dog: A Memoir by the Creator of Nike -||-  //amzn.to/2fL2x2L
The Inevitable: Understanding the 12 Technological Forces that Will Shape Our Future -||-  //amzn.to/2vJ5dSs
Ronald Reagan -||-  //amzn.to/2i5Bbow
The Inner Lives of Markets: How People Shape Them And They Shape Us: Ray Fisman & Tim Sullivan -||-  //amzn.to/2w1GmM1
The Seventh Sense: Power, Fortune, and Survival in the Age of Networks -||-  //amzn.to/2x4eR1x
Alexander Hamilton by:Ron Chernow -||-  //amzn.to/2fJZZC0
Tattoos on the Heart: The Power of Boundless Compassion—Gregory Boyle -||-  //amzn.to/2vIzccW
Cathcher in the Rye -||-  //amzn.to/2vIItEv
Titan: The Life of John D. Rockefeller, Sr. -||-  //amzn.to/2fLs8bM
48 Laws of Power - Robert Greene -||-  //amzn.to/2vDYY3N
Influence: The Psychology of Persuasion -||-  //amzn.to/2w285MR
Berkshire Hathaway Letters to Shareholders -||-  //amzn.to/2uICobx
Confessions of an Advertising Man -||-  //amzn.to/2wPS8Xq
Team of Rivals: The Political Genius of Abraham Lincoln -||-  //amzn.to/2fL5NLB
The Intelligent Investor: The Definitive Book on Value Investing -||-  //amzn.to/2uIKFMt
The Wealth of Nations  -||-  //amzn.to/2w2jcFu
The Adweek Copywriting Handbook: The Ultimate Guide to Writing Powerful Advertising and Marketing y -||-  //amzn.to/2vIqprO
Ogilvy on Advertising -||-  //amzn.to/2fLL2PC
Mastery: Robert Greene -||-  //amzn.to/2w2a2c9
Plato's Republic -||-  //amzn.to/2vDDzaV
A Confederacy of Dunces -||-  //amzn.to/2w1J2Jy
33 Strategies of War -||-  //amzn.to/2uIkQfI
A People's History of the United States: 1492 to Present -||-  //amzn.to/2wQgS23
Meditations of Marcus Aurelius -||-  //amzn.to/2wPPdOt
The Tao of Seneca: Practical Letters from a Stoic Master, Volume 1 -||-  //amzn.to/2x4r5Hd
Technocracy in America: Rise of the Info-State -||-  //amzn.to/2CtO7tD
HBR's 10 Must Reads on Change Management -||-  //amzn.to/2wQ8LSW
HBR's 10 Must Reads on Teams -||-  //amzn.to/2uJ6NX5
HBR's 10 Must Reads on Collaboration -||-  //amzn.to/2fLkHRS
HBR's 10 Must Reads on Leadership -||-  //amzn.to/2fLuszp
HBR's 10 Must Reads on Managing People -||-  //amzn.to/2x4fLuA
HBR's 10 Must Reads on Managing Yourself -||-  //amzn.to/2vIIkyl
HBR's 10 Must Reads on Communication -||-  //amzn.to/2w1Ziuc
HBR's 10 Must Reads on Making Smart Decisions -||-  //amzn.to/2i6uxyA
HBR’s 10 Must Reads on Emotional Intelligence -||-  //amzn.to/2wQJF6j
The Lean Startup: Ries -||-  //amzn.to/2vqa6PY
1776: David McCullough -||-  //amzn.to/2vmyGTG
Drive: The Surprising Truth About What Motivates Us -||-  //amzn.to/2vImCgc
Purple Cow: Seth Godin -||-  //amzn.to/2vpQjQF
The Hard Thing About Hard Things : Horowitz -||-  //amzn.to/2vqa6zF
I, Robot : Asimov -||-  //amzn.to/2hOcRHO
Start With Why: Simon Sinek -||-  //amzn.to/2wxho4D
Seven Men: And the Secret of Their Greatness : Metaxas -||-  //amzn.to/2vlXXgy
Zero to One: Notes on Startups: Peter Thiel -||-  //amzn.to/2wxKzEM
The Signal And the Noise: Nate Silvers -||-  //amzn.to/2fvhh5v
Home Game: Michael Lewis -||-  //amzn.to/2hOugjy
Unbroken: A World War II Story -||-  //amzn.to/2hNpbYF
Great Courses: The Art of Negotiating The Best Deal: Prof: Seth Freeman -||-  //amzn.to/2wxnli5
Business Strategy: Spender -||-  //amzn.to/2fw1GTr
Book of Leadership Wisdom -||-  //amzn.to/2uscg4z
Power: Why Some People Have It -||-  //amzn.to/2wxdBnS
The Art of War: Tsu -||-  //amzn.to/2us7AM0
Naked Sun: Asimov -||-  //amzn.to/2vmNIJ4
Chase The Lion: Mark Batterson -||-  //amzn.to/2hNKXLS
East of Eden: Steinbeck -||-  //amzn.to/2vIxyLb
Thinking Fast and Thiking Slow: Daniel Kahneman -||-  //amzn.to/2vIo7ek
If You Can Keep It: Metaxas -||-  //amzn.to/2vICuzz
Art of Innovation: Tom Kelley -||-  //amzn.to/2wxLUeM
Ten Faces of Innovation: Tom Kelley -||-  //amzn.to/2wLDH5Y
In a Pit With a Lion on a Snowy Day -||-  //amzn.to/2vmuiUx
The Undoing Project: Michael Lewis -||-  //amzn.to/2usxaQY
Founders Dilemmas: Noam Wasserman -||-  //amzn.to/2hNTONW
How to Win Friends & Influence People: Carnegie -||-  //amzn.to/2vmAEU4
Glory Days: Living Your Promise -||-  //amzn.to/2vqgWVT
Great Courses: Becoming a Great Essayist -||-  //amzn.to/2fuzfoW
Misbehaving: The Making of Behavioral Finance -||-  //amzn.to/2vIBriZ
The Caves of Steel: Asimov -||-  //amzn.to/2furBuN
The Robots of Dawn: Asimov -||-  //amzn.to/2vIz7su
Competitive Forces: Michael E Porter -||-  //amzn.to/2wxMOrG
Big, Hot, Cheap, and Right: What America Can Learn from the Strange Genius of Texas -||-  //amzn.to/2hOwmjq
Steve Jobs: Walter Issacson -||-  //amzn.to/2wxhzgn
The Pursuit of God : A. W. Tozer -||-  //amzn.to/2wLUZ2G
Great Courses: Strategic Thinking Skills -||-  //amzn.to/2vpZBfC
Great Courses: Influence: Mastering Life's Most -||-  //amzn.to/2vIX2YI
Great Courses: Writing Great Fiction -||-  //amzn.to/2usssTq
Great Courses: Effective Communication Skills -||-  //amzn.to/2vIOJcO
Great Courses: Building Great Sentences -||-  //amzn.to/2wxvmDI
Great Courses: Art of Storytelling -||-  //amzn.to/2vn3pA4
The Stars Like Dust: Asimov -||-  //amzn.to/2fvoPp2
Pitch Anything -||-  //amzn.to/2hNVPK0
Benjamin Franklin: Walter Issacson -||-  //amzn.to/2vmOc1V
My Early Life: Winston Churchill -||-  //amzn.to/2wLAUd6